49,66,,,,,,,,,,,,,,,,,,,,,,,,,,,,,,,,,,,,,,,,,,,,,,,
2,2,2,2,2,2,2,2,2,2,2,2,2,2,2,2,2,2,2,2,2,2,2,2,2,2,2,2,2,2,2,2,2,2,2,2,2,2,2,2,2,2,2,2,2,2,2,2,2
2,2,2,2,2,2,2,2,2,2,2,2,2,2,2,2,2,2,2,2,2,2,2,2,2,2,2,2,2,2,2,2,2,2,2,2,2,2,2,2,2,2,2,2,2,2,2,2,2
2,2,3,3,3,3,3,3,3,3,3,3,3,3,3,3,3,3,3,3,3,3,3,3,3,3,3,3,3,2,2,2,2,2,2,3,3,3,3,3,2,2,2,2,2,2,2,2,2
2,2,0,0,0,0,0,0,0,0,0,0,0,0,0,0,0,0,0,0,0,0,100,102,0,0,0,0,0,2,2,2,2,2,2,0,0,4,0,0,2,2,2,2,2,2,2,2,2
2,2,0,0,0,0,0,0,0,0,0,0,0,0,0,0,0,0,0,0,0,0,100,102,0,0,0,0,0,2,2,2,2,2,2,0,0,0,0,0,2,2,2,2,2,2,2,2,2
2,2,0,0,0,0,0,0,0,0,0,0,0,0,0,0,0,0,0,0,0,0,100,102,0,0,0,4,0,2,2,2,2,2,2,2,0,0,0,2,2,2,2,2,2,2,2,2,2
2,2,0,0,0,0,0,0,0,0,0,0,0,0,0,0,0,0,0,0,0,0,100,102,0,0,0,0,0,2,2,2,2,3,3,3,0,0,0,3,3,3,3,2,2,2,2,2,2
2,2,0,0,0,0,0,0,0,0,0,0,0,0,0,0,0,0,0,0,0,0,100,102,0,0,0,0,0,2,2,2,2,0,0,0,0,0,0,0,0,0,0,2,2,2,2,2,2
2,2,0,0,0,0,0,0,0,0,0,0,0,0,0,0,0,0,0,0,0,0,100,102,0,0,0,0,0,2,2,2,2,0,0,0,0,0,0,0,0,0,0,2,2,2,2,2,2
2,2,0,0,0,2,2,0,0,0,2,2,2,2,2,2,2,0,0,0,0,0,100,102,0,0,0,0,0,2,2,2,2,0,0,0,0,0,0,0,0,0,0,2,2,3,3,2,2
2,2,0,0,0,2,2,0,0,0,2,2,3,3,3,3,3,0,0,0,0,0,2,2,0,0,0,0,0,3,3,3,3,0,0,0,2,2,2,2,0,0,0,3,3,0,0,2,2
2,2,0,0,0,2,2,0,0,0,2,2,0,0,0,0,0,0,0,0,0,0,2,2,0,0,0,0,0,0,0,0,0,0,0,0,2,2,2,2,0,0,0,0,0,0,0,2,2
2,2,0,0,0,2,2,0,0,0,2,2,101,101,0,0,0,0,0,0,0,0,2,2,0,0,0,0,0,0,0,0,0,0,0,0,2,2,2,2,0,0,0,0,0,0,4,2,2
2,2,5,0,0,2,2,0,0,0,2,2,101,101,0,0,0,0,0,0,0,0,2,2,0,0,0,0,0,0,0,0,0,0,0,0,2,2,2,2,0,0,0,0,0,0,0,2,2
2,2,0,0,0,2,2,0,0,0,2,2,0,0,0,0,0,0,0,0,0,0,2,2,0,0,0,0,0,0,0,0,0,0,0,0,2,2,2,2,0,0,0,2,2,0,0,2,2
2,2,0,0,0,2,2,0,5,0,2,2,2,2,2,2,2,0,0,0,0,0,2,2,0,0,0,0,0,0,0,0,0,0,0,0,2,2,2,2,0,0,0,2,2,2,2,2,2
2,2,0,0,0,2,2,0,0,0,2,2,2,2,2,2,2,0,0,0,0,0,2,2,0,0,0,0,0,2,2,2,2,0,0,0,3,3,3,3,0,0,0,2,2,2,2,2,2
2,2,0,0,0,2,2,2,2,2,2,3,3,3,3,2,2,2,2,2,2,2,2,2,0,0,0,0,0,2,2,2,2,0,0,0,0,0,0,0,0,0,0,2,2,2,2,2,2
2,2,100,100,100,2,2,2,2,2,2,0,0,0,0,2,2,2,2,2,2,2,2,2,0,0,0,0,0,2,2,2,2,0,0,0,0,0,0,0,0,0,0,2,2,2,2,2,2
2,2,10,10,10,3,3,3,3,3,3,0,0,0,0,3,3,3,3,3,3,3,2,2,0,0,0,0,0,2,2,2,2,0,0,0,0,0,0,0,0,0,0,2,2,2,2,2,2
2,2,0,0,0,0,0,0,0,0,0,0,0,0,0,0,0,0,0,0,0,0,2,2,0,0,0,0,0,2,2,2,2,0,0,0,0,0,0,0,0,0,0,2,2,2,2,2,2
2,2,0,0,0,0,0,0,0,0,0,0,0,0,0,0,0,0,0,0,0,0,2,2,0,0,0,0,0,2,2,2,2,2,2,2,0,0,0,2,2,2,2,2,2,2,2,2,2
2,2,0,0,0,0,0,0,0,0,0,0,0,0,0,0,0,0,0,0,0,0,2,2,0,0,0,0,0,2,2,2,2,2,2,2,0,0,0,2,2,2,2,2,2,2,2,2,2
2,2,2,2,2,2,2,2,2,2,2,2,2,2,2,2,2,2,2,0,0,0,2,2,0,0,0,0,0,2,2,2,2,2,2,3,0,0,0,3,2,2,2,2,2,2,2,2,2
2,2,3,3,3,3,3,3,3,3,3,3,3,3,3,3,3,2,2,10,10,10,2,2,102,102,102,2,2,2,2,2,2,2,2,0,0,0,0,0,2,2,2,2,2,2,2,2,2
2,2,0,0,0,0,0,0,0,0,0,0,0,0,0,0,0,2,2,0,0,0,2,2,0,0,0,2,2,2,2,2,2,2,2,0,0,5,0,0,2,2,2,2,2,2,2,2,2
2,2,0,0,0,0,0,0,0,0,0,0,0,0,0,0,0,2,2,0,0,0,2,2,104,104,104,2,2,2,2,2,2,2,2,2,2,2,2,2,2,2,2,2,2,2,2,2,2
2,2,0,0,0,0,0,0,0,0,0,0,0,0,0,0,0,2,2,0,0,0,2,2,0,0,0,2,2,2,2,2,2,2,2,2,2,2,2,2,2,2,2,2,2,2,2,2,2
2,2,0,0,0,2,2,0,0,0,2,2,2,2,0,0,0,2,2,0,0,0,2,2,0,0,0,2,2,2,3,3,3,3,3,3,3,3,3,3,3,3,3,3,3,3,3,2,2
2,2,0,0,0,2,2,0,0,0,2,2,2,2,0,0,0,2,2,0,0,0,2,2,0,0,0,2,2,2,0,0,0,0,0,0,0,0,8,0,0,0,0,0,0,0,0,2,2
2,2,0,0,0,2,2,0,0,0,2,2,2,2,0,0,0,2,2,0,0,0,2,2,0,0,0,2,2,2,0,0,0,0,0,0,0,0,8,0,0,0,0,0,0,0,0,2,2
2,2,0,0,0,2,2,0,0,0,2,2,2,2,0,0,0,2,2,0,0,5,2,2,0,0,0,2,2,2,0,0,0,0,0,0,0,0,8,0,0,0,0,0,0,0,0,2,2
2,2,0,0,0,2,2,0,0,0,2,2,2,2,0,0,0,2,2,0,0,0,2,2,0,0,0,2,2,2,0,0,0,2,2,2,2,2,2,2,0,0,0,0,2,2,2,2,2
2,2,0,0,0,2,2,0,0,0,2,2,2,2,0,0,0,2,3,0,0,0,2,2,8,8,8,2,2,2,0,0,0,2,2,2,2,2,2,2,0,0,0,0,2,2,2,2,2
2,2,0,0,0,2,2,0,0,0,2,2,2,2,0,0,0,2,0,0,0,0,2,2,0,0,0,3,3,3,0,0,0,2,2,3,3,3,3,3,0,0,0,0,2,2,2,2,2
2,2,0,0,0,2,2,0,0,0,3,3,3,3,0,0,0,3,0,0,0,0,2,2,0,0,0,0,0,0,0,0,0,2,2,0,0,0,0,0,0,0,0,0,2,2,2,2,2
2,2,0,0,0,2,2,0,0,0,0,0,0,0,0,0,0,10,0,0,0,0,2,2,0,0,0,0,0,0,0,0,0,2,2,0,0,0,0,0,0,0,0,0,3,3,3,2,2
2,2,0,0,0,2,2,0,0,0,0,0,0,0,0,0,0,10,0,0,0,0,2,2,0,0,0,0,0,0,0,0,0,2,2,0,0,0,0,0,0,0,0,0,0,0,0,2,2
2,2,0,0,0,2,2,0,0,0,0,0,0,0,0,0,0,10,0,0,0,0,2,2,0,0,0,0,0,0,0,0,0,2,2,0,0,0,0,0,0,0,0,0,0,0,0,2,2
2,2,0,0,0,2,2,2,2,2,2,2,2,2,2,2,2,2,2,2,2,2,2,2,0,0,0,0,0,0,0,5,0,2,2,0,0,0,2,2,2,0,0,0,0,0,0,2,2
2,2,0,0,0,3,3,3,3,3,3,2,2,2,2,2,2,2,2,2,2,2,2,2,2,2,2,2,2,2,2,2,2,2,2,0,0,0,2,2,2,0,0,0,0,0,0,2,2
2,2,0,0,0,0,0,0,0,0,0,2,2,3,3,3,3,3,3,3,3,2,2,2,2,2,2,2,2,2,2,2,2,2,2,0,0,0,2,2,2,2,2,2,0,0,0,2,2
2,2,0,0,0,0,0,0,0,5,0,2,2,0,0,0,0,0,0,0,0,2,2,2,2,2,2,2,2,2,2,2,2,2,2,0,0,0,2,2,2,2,2,2,0,0,0,2,2
2,2,0,0,0,8,0,0,0,0,0,2,2,0,5,0,0,0,0,8,0,3,3,3,3,3,3,3,3,3,3,3,3,3,3,0,0,0,3,3,3,2,2,2,0,0,0,2,2
2,2,0,0,0,0,0,0,0,0,0,2,2,0,50,50,50,50,0,0,0,0,0,0,0,0,0,0,104,0,0,0,0,0,0,0,0,0,0,0,0,2,2,2,0,0,0,2,2
2,2,0,0,0,0,0,0,0,0,0,2,2,0,50,50,50,50,0,0,0,0,0,0,0,0,0,0,104,0,0,0,0,0,0,0,0,0,0,0,0,3,3,3,0,0,0,2,2
2,2,0,0,0,0,0,0,0,0,0,2,2,0,50,50,50,50,0,0,0,0,0,0,0,0,0,0,104,0,0,0,0,0,0,0,0,0,0,0,0,0,0,0,0,0,0,2,2
2,2,0,0,0,0,0,0,0,0,0,2,2,0,50,50,50,50,0,0,0,0,0,0,0,0,0,0,104,0,0,0,0,0,0,0,0,0,0,0,0,0,0,0,0,0,0,2,2
2,2,0,5,0,0,0,0,8,0,0,2,2,0,50,50,50,50,0,0,0,0,0,0,0,0,0,0,104,0,0,0,0,0,0,0,0,0,0,0,0,0,0,0,0,0,0,2,2
2,2,0,0,0,0,0,0,0,0,0,2,2,0,0,0,5,0,0,0,0,0,0,0,0,0,0,0,104,0,0,0,0,0,0,0,0,0,0,0,0,0,0,0,0,0,0,2,2
2,2,2,2,2,0,0,2,2,2,2,2,2,0,0,0,0,0,0,0,0,0,0,0,0,0,0,0,104,0,0,0,0,0,0,0,0,0,0,0,0,0,0,0,0,0,0,2,2
2,2,2,2,2,0,0,2,2,2,2,2,2,2,2,2,2,2,2,2,2,2,2,2,2,2,2,2,2,2,2,2,2,2,2,2,2,2,2,2,2,2,2,2,2,2,2,2,2
2,2,2,2,2,0,0,2,2,2,2,2,2,2,2,2,2,2,2,2,2,2,2,2,2,2,2,2,2,2,2,2,2,2,2,2,2,2,2,2,2,2,2,2,2,2,2,2,2
2,2,3,3,3,0,0,3,3,3,3,3,3,3,3,3,3,3,3,3,3,3,3,3,3,3,3,3,3,3,3,3,3,3,3,3,3,3,3,3,3,3,3,3,3,3,3,2,2
2,2,0,0,0,0,0,0,0,0,0,0,0,0,0,0,0,0,0,0,0,0,0,0,0,0,0,0,0,0,0,0,0,0,0,0,0,0,0,0,0,0,0,0,0,0,0,2,2
2,2,0,0,0,0,0,0,0,0,0,0,0,0,0,0,0,0,0,0,0,0,0,0,0,0,0,0,0,0,0,0,0,0,0,0,0,0,0,0,0,0,0,0,0,0,0,2,2
2,2,0,0,0,0,0,0,0,0,0,0,0,0,0,0,0,0,0,0,0,0,0,0,0,0,0,0,0,0,0,0,0,0,0,0,0,0,0,0,0,0,0,0,0,0,0,2,2
2,2,0,0,0,0,0,0,0,0,0,0,0,0,0,0,0,0,0,0,0,0,0,0,0,0,0,0,0,0,0,0,0,0,0,0,0,0,0,0,0,0,0,0,0,0,0,2,2
2,2,0,0,0,0,0,0,0,0,0,0,0,0,0,0,0,0,0,0,0,0,0,0,0,0,0,0,0,0,0,0,0,0,0,0,0,0,0,0,0,0,0,0,0,0,0,2,2
2,2,0,0,0,0,0,0,0,0,0,0,0,0,0,0,0,0,0,0,0,0,0,0,0,0,0,0,0,0,0,0,0,0,0,0,0,0,0,0,0,0,0,0,0,0,0,2,2
2,2,0,0,0,0,0,0,0,0,0,0,0,0,0,0,0,0,0,0,0,0,0,0,0,0,0,0,0,0,0,0,0,0,0,0,0,0,0,0,0,0,0,0,0,0,0,2,2
2,2,0,0,0,0,0,0,0,0,0,0,0,0,0,0,0,0,0,0,0,0,0,0,0,0,0,0,0,0,0,0,0,0,0,0,0,0,0,0,0,0,0,0,0,0,0,2,2
2,2,0,0,0,0,0,0,0,0,0,0,0,0,0,0,0,0,0,0,0,0,0,0,0,0,0,0,0,0,0,0,0,0,0,0,0,0,0,0,0,0,0,0,0,0,0,2,2
2,2,2,2,2,2,2,2,2,2,2,2,2,2,2,2,2,2,2,2,2,2,2,2,2,2,2,2,2,2,2,2,2,2,2,2,2,2,2,2,2,2,2,2,2,2,2,2,2
2,2,2,2,2,2,2,2,2,2,2,2,2,2,2,2,2,2,2,2,2,2,2,2,2,2,2,2,2,2,2,2,2,2,2,2,2,2,2,2,2,2,2,2,2,2,2,2,2
2,2,2,2,2,2,2,2,2,2,2,2,2,2,2,2,2,2,2,2,2,2,2,2,2,2,2,2,2,2,2,2,2,2,2,2,2,2,2,2,2,2,2,2,2,2,2,2,2
